F 153,150,80
C 110,108,55

NO ./textures/north.xpm
SO ./textures/south.xpm
WE ./textures/west.xpm
EA ./textures/east.xpm



 11111111
1N00000001
1000000001
1000000001
1000000001
1000000001
1000000001
1000000001
1000000001
 11111111