NO ./textures/north.xpm
SO ./textures/south.xpm
WE ./textures/west.xpm
EA ./textures/east.xpm

F 153,150,80
C 110,108,55

 11111111
1000000001
1000000001
 11100111
10000N0001
1111111111
1000000001
1000000001
1111111111
1111111111
1000000001
 11111111