NO ./textures/north.xpm
SO ./textures/south.xpm
WE ./textures/west.xpm
EA ./textures/east.xpm

F 153,150,80
C 110,108,55

11111111
11111                   111
1111111111              11
1001N00001         111111
1000   0001         111111
100000000111111111    1101
1000000001             1 1
1000000001              1
1000000001
1000000001
1000000001
1111111111