F 153,150,80
C 110,108,55

NO ./textures/north.xpm
SO ./textures/south.xpm
WE ./textures/west.xpm
EA ./textures/east.xpm

1111
1001
10N1
1111