



   WE                            ./textures/west.xpm
NO      ./textures/north.xpm
F      17,38,64
SO ./textures/south.xpm
EA ./textures/east.xpm




C 218,234,235

1111111111111111111111111      1111111
10S0110000100000000000001     100000001   1
1000110000000000111111001   11111111111111111
1000110000000000110001001
1000000000100000000001001
1111111111111111111111111